0000000000000000000000000000000000000
0000000000000000000000000000000000000
0000000000000000000000000000000000000
000000000001000s000000200i0000i000000
3333333333333333333333333333333333333