00000000000000
00000000000000
00000000010000
00333333333333
00000000000000
00000000000000


