000000000gg000
00000000333333
00000000000000
000100l00c0000
33333333333333


