0000000000000033333333333333333333333
0000000000000000000000000000000000000
0000000000000000000000000000000000000
0100000000000000000000000000000000000
3333333333333333333333333333333333333