3333333333333333333333333333333333333
3000000000000000000000000000000000003
3000000000000000000000000000000000003
3000000000000000000000000000000000003
3000000000000000000000000000000000003
3000000000000000000000000000000000003
3000000000000000000000000000000000003
3000000000000000000000000000000000003
3000000000000000000000000000000000003
3100000002222222000000000000000000003
3333333333333333333333333333333333333
