3333333333333333333333333333333333333
3000000000000000000000000000000000003
3000000000000000000000000000000000003
3000000000000000000000000000000000003
3000000000000000010000000000000000003
3000000002000000002000000002000000003
3000000002000000002000000002000000003
3000000002000000002000000002000000003
3000000002000000002000000002000000003
3000000002000000002000000002000000003
3333333333333333333333333333333333333