3000000000000000000000000000000000003
3000000000000000000000000000000000003
3000000000000000000000000000000000003
3000000000000000000000000000000000003
3000000000000000000000000000000000003
3000000000000000000000000000000000003
3000000000000000000000000000000000003
3000000001000000000000000000000000003
3000000000000000000000000000000000003
000000000000000000000lll0000000000000
0000000000000000000000000000000000003
3333333333333333333333333333333333333