00000000333333
00000000000000
00000000000000
00010000000000
33333333333333


