3000000000000000000000000000000000003
3000000000000000000000000000000000003
3000000000000000000000000000000000003
3000000000000000000000000000000000003
3000000000000000000000000000000000003
3000000000000000000000000000000000003
3000000000000000000000000000000000003
3000000000000000000000000000001000003
3000000000000000000000000000000000003
3000000000000000000000000000000000000
30000000000000000i0000000000000000003
3333333333333333333333333333333333333