
3333333333333333333333333333333333333
3000000000000000000000000000000000003
3000000000000000000000000000000000003
3000000000000000000000000000000000003
3000000000000000000000000000000000003
3000000000000000000000000000000000003
3000000000000000000000000000000000003
3000000000000000000000000000000000003
3000000000000000122000000000000000003
3000000000000000000000000000000000003
3333333333333333333333333333333333333
