00000300000001
00333333333333
00000000000000
00000000000000
00000000000000
00000000000000
000322222222222222222222222222222222222222222222
33333333333333

