0000000000000033333333333333333333333
0000000000000000000000000000000000000
0000000000000000000000000000000000000
000000000001000000000000i000000000000
3333333333333333333333333333333333333