00000000000001
33333333333333
00000000000000
02222222222200
33333333333333

