3000000000000000000000000000000000003
3000000000000000000000000000000000003
3000000000000000000000000000000000003
3000000000000000000000000000000000003
3000000000000000000000000000000000003
3000000000000000000000000000000000003
3000000000000000000000000000000000003
3000000000000000000000000000001000003
3000000000000000000000000000000000003
3000000000000000000000000000000000000
3000000000000000020000000000000000003
3333333333333333333333333333333333333