00000300000001
00333333333333
00000000000000
00000000000000
00000000000000
00000000000000


